111111111
111111111
111111111
111111111
111111111
222222222
333333333
444444444
555555555
