9 9
111111111
111111111
111111111
111111111
111111111
222222222
333333333
444444444
555555555
3 3,1 3,2 3,3
4 4,1 4,2 4,3
5 5,1 5,2 5,3