0000000000000000
0002100000012000
0011110000111100
0311113113111130
0111111411111110
0031110000111300
0001114004111000
0010111111110100
0010031111300100
0111111111111110
041111141111140
0000001111000000
0000000150000000
0000000000000000
