17 14
00000000000000000
00021000000012000
00111100000111100
03111131113111130
01111111411111110
00311100000111300
00011140004111000
00101111011110100
00100311111300100
01111111111111110
04111111411111140
00000011111000000
00000001510000000
00000000000000000
3 3,1 13,1 3,6 13,6 1,9 8,9 15,9 7,12 8,12 9,12
4 6,6 10,6
5 7,10