10 10
1111111110
1111111110
1111111110
1111111110
1111111110
2222222220
3333333330
4444444440
5555555550
0000000000
3 0,6 0,7 0,8 0,9
4 9,0 9,1 9,2 9,3